4 4
0 0 0 0
0 0 0 0
0 0 0 0
0 0 0 0
5
9 201 1 205 1 203 1 203 1 187
9 204 1 203 1 185 2 186 2 186
9 186 2 204 1 185 2 204 1 185
9 186 2 204 1 202 1 185 2 186
9 200 1 202 1 205 1 202 1 188
5 186 2 186 186 186
5 186 186 186 186 186
5 186 186 186 186 186
5 186 186 2 186 186 

