6 6
0 0 0 0 0 0
0 0 0 0 0 0
0 0 0 0 0 0
0 0 0 0 0 0
0 0 0 0 0 0
0 0 0 0 0 0
7
13 201 1 205 1 205 1 203 1 205 1 203 1 187
13 204 1 203 1 205 1 202 1 203 1 185 2 186
13 186 2 204 1 203 1 203 1 185 2 204 1 185
13 204 1 185 2 200 1 185 2 186 2 186 2 186
13 186 2 204 1 205 1 202 1 202 1 206 1 185
13 204 1 206 1 205 1 203 1 205 1 188 2 186
13 200 1 202 1 205 1 202 1 205 1 205 1 188
7 186 2 2 186 2 186 186
7 186 186 2 2 186 186 186
7 186 186 186 186 186 186 186
7 186 186 2 186 186 186 186
7 186 186 2 2 2 186 186
7 186 186 2 186 2 2 186