9 9
0 0 0 0 0 0 0 0 0
0 0 0 0 0 0 0 0 0
0 0 0 0 0 0 0 0 0
0 0 0 0 0 0 0 0 0
0 0 0 0 0 0 0 0 0
0 0 0 0 0 0 0 0 0
0 0 0 0 0 0 0 0 0
0 0 0 0 0 0 0 0 0
0 0 0 0 0 0 0 0 0
10
19 201 1 205 1 203 1 203 1 205 1 205 1 203 1 205 1 203 1 187
19 204 1 203 1 206 1 202 1 205 1 203 1 202 1 203 1 185 2 186
19 186 2 186 2 204 1 203 1 187 2 204 1 205 1 185 2 200 1 185
19 186 2 204 1 188 2 186 2 200 1 185 2 196 2 204 1 203 1 185
19 204 1 206 1 205 1 202 1 203 1 206 1 205 1 185 2 204 1 185
19 186 2 204 1 203 1 205 1 185 2 204 1 203 1 185 2 186 2 186
19 204 1 188 2 204 1 205 1 185 2 186 2 186 2 204 1 206 1 185
19 204 1 203 1 206 1 205 1 202 1 202 1 185 2 186 2 186 2 186
19 186 2 204 1 202 1 205 1 203 1 203 1 202 1 185 2 200 1 185
19 200 1 202 1 205 1 205 1 202 1 202 1 205 1 202 1 205 1 188
10 186 2 186 186 2 2 186 2 186 186
10 186 186 186 2 2 186 2 186 186 186
10 186 186 186 186 186 186 2 186 2 186
10 186 186 2 186 2 186 2 186 186 186
10 186 186 2 2 186 186 2 186 186 186
10 186 186 186 2 186 186 186 186 186 186
10 186 2 186 2 186 186 186 186 186 186
10 186 186 186 2 2 2 186 186 186 186
10 186 186 2 2 186 186 2 186 2 186
 